0 0 0 0 0 0 0 0 0 0 0 0 0 0 0 0 0 0 0 0 0 0 0 1 0 0 0 0 0 0 0 0 0 0 0 0 0 0 0 0
0 0 0 0 0 0 0 0 0 0 0 0 0 0 0 0 0 0 0 0 0 0 0 3 0 0 0 0 0 0 0 0 0 0 0 0 0 0 0 0
0 0 0 0 0 0 0 0 0 0 0 0 0 0 0 0 0 0 0 0 0 0 0 1 1 1 3 1 1 6 5 1 4 3 4 6 0 1 6 7
0 0 0 0 0 0 0 0 0 0 0 0 0 0 0 0 4 4 4 4 4 0 0 0 0 0 0 0 0 0 0 0 0 1 1 1 0 4 0 0
0 0 0 0 0 0 0 0 0 0 0 0 0 0 0 0 0 0 0 0 0 0 4 1 1 3 0 0 0 0 0 0 0 0 2 1 0 1 0 0
1 4 3 1 0 0 0 0 0 0 0 0 0 0 0 0 0 0 4 1 2 1 5 4 1 1 0 0 0 0 0 0 0 0 0 6 0 6 0 0
5 1 1 4 4 0 0 0 0 3 1 1 0 0 0 0 0 1 6 5 1 1 2 5 1 1 5 0 0 0 0 0 0 0 0 0 0 5 0 0
1 1 4 2 1 1 0 0 4 7 5 7 1 0 0 0 1 1 2 4 1 1 1 1 1 1 1 0 0 0 0 0 0 0 0 0 0 0 0 0
1 0 0 1 6 1 1 2 1 1 1 5 1 1 0 4 4 3 5 6 6 1 1 1 3 7 1 6 5 0 0 4 1 1 1 1 1 3 1 1
3 0 0 0 0 1 2 3 1 1 1 1 6 1 1 2 7 1 1 1 0 0 1 5 1 7 1 1 0 0 0 0 1 1 2 7 2 7 1 1
1 0 0 0 0 0 0 0 0 0 0 1 5 6 1 0 0 0 0 0 0 0 0 0 0 0 0 0 0 0 0 0 0 0 0 0 0 0 0 1
5 0 0 0 1 3 1 1 2 7 1 1 1 1 1 0 0 0 0 0 1 4 1 5 6 3 3 3 1 0 0 2 1 4 1 0 0 0 0 1
1 0 0 1 0 0 0 0 0 0 0 0 0 0 0 0 0 0 0 0 0 0 5 4 1 1 1 1 4 0 0 1 1 6 0 1 0 0 0 4
4 5 0 0 0 0 0 0 0 3 7 1 2 1 0 0 0 0 0 0 0 0 0 2 1 1 3 2 5 0 0 1 5 1 0 0 1 0 0 1
1 3 1 0 0 0 0 0 4 1 2 5 6 3 1 3 0 0 2 5 4 1 0 0 1 3 3 1 3 0 0 5 1 1 0 0 0 0 1 6
1 2 1 1 0 0 0 1 1 1 6 1 3 1 1 1 0 0 6 1 6 1 7 0 0 3 5 1 3 0 0 5 2 1 0 0 0 1 5 1
1 0 0 0 0 0 4 5 3 1 6 5 1 7 0 0 0 0 1 1 1 1 6 1 0 0 0 4 1 0 0 3 1 7 0 0 1 7 6 3
3 0 0 0 0 2 1 1 1 6 1 6 1 6 0 0 0 0 0 0 0 1 1 3 1 0 0 0 0 0 0 0 0 0 0 1 4 1 1 1
1 0 0 0 1 1 3 1 1 1 1 6 1 1 5 4 6 1 6 1 0 0 0 0 0 0 2 0 0 0 0 0 0 0 1 1 1 1 1 1
4 1 7 6 1 2 1 7 6 3 5 6 1 5 1 7 4 1 1 1 7 2 7 1 1 1 3 1 3 1 7 6 3 1 1 1 1 1 1 1
