0 0 0 0 0 0 0 0 0 0 0 0 0 0 0 0 0 0 0 0 0 0 0 1 0 0 0 0 0 0 0 0 0 0 0 0 0 0 0 0
0 0 0 0 0 0 0 0 0 0 0 0 0 0 0 0 0 0 0 0 0 0 0 3 0 0 0 0 0 0 0 0 0 0 0 0 0 0 0 0
0 0 0 0 0 0 0 6 0 0 0 0 0 0 0 0 0 0 0 0 0 0 0 1 1 1 3 1 1 6 5 1 4 3 4 6 0 1 6 7
0 0 0 0 0 0 0 0 0 0 6 0 0 0 0 0 4 4 4 4 4 0 0 0 0 0 0 0 0 0 0 0 0 1 1 1 0 4 0 0
0 0 0 0 0 0 0 0 0 0 0 0 5 5 0 0 0 0 0 0 0 0 4 1 1 3 0 0 0 0 0 0 0 0 2 1 0 1 0 0
1 4 3 1 0 0 0 0 0 0 0 0 0 0 0 0 0 0 4 1 2 1 5 4 1 1 0 0 0 0 0 0 0 0 0 6 0 6 0 0
5 1 1 4 4 0 0 0 0 3 1 1 0 0 0 0 0 1 6 5 1 1 2 5 1 1 5 0 0 0 0 0 0 0 0 0 0 5 0 0
1 1 4 2 1 1 0 0 4 7 5 7 1 0 0 0 1 1 2 4 1 1 1 1 1 1 1 0 0 0 0 0 0 0 0 0 0 0 0 0
1 0 0 1 6 1 1 2 1 1 1 5 1 1 0 4 4 3 5 6 6 1 1 1 3 7 1 6 5 0 0 4 1 1 1 1 1 3 1 1
0 0 0 0 0 0 0 0 0 0 0 0 6 0 0 0 7 0 0 0 0 0 0 5 0 7 0 0 0 0 0 0 0 0 0 7 0 7 0 0
0 0 0 0 0 0 0 0 0 0 0 0 5 6 0 0 0 0 0 0 0 0 0 0 0 0 0 0 0 0 0 0 0 0 0 0 0 0 0 0
5 0 0 0 0 0 0 0 0 7 0 0 0 0 0 0 0 0 0 0 0 0 0 5 6 0 0 0 0 0 0 0 0 0 0 0 0 0 0 0
0 0 0 0 0 0 0 0 0 0 0 0 0 0 0 0 0 0 0 0 0 0 5 0 0 0 0 0 0 0 0 0 0 6 0 0 0 0 0 0
0 5 0 0 0 0 0 0 0 0 7 0 0 0 0 0 0 0 0 0 0 0 0 0 0 0 0 0 5 0 0 0 5 0 6 0 0 0 0 0
0 0 0 0 0 0 0 0 0 0 0 5 6 0 0 0 0 0 0 5 0 0 0 0 0 0 0 0 0 0 0 5 0 0 0 0 6 0 0 6
0 0 0 0 0 0 0 0 0 0 6 0 0 0 0 0 0 0 6 0 6 0 7 0 0 0 5 0 0 0 0 5 0 0 6 0 0 0 5 0
0 0 0 0 0 0 0 5 0 0 6 5 0 7 0 0 0 0 0 0 0 0 6 0 0 0 0 0 0 0 0 0 0 7 0 5 5 7 6 0
0 0 0 0 0 0 0 0 0 6 0 6 0 6 0 0 0 0 0 0 0 0 0 0 0 0 0 0 0 0 0 6 6 0 0 0 0 0 0 0
0 0 0 0 0 0 0 0 0 0 0 6 0 0 5 0 6 0 6 0 0 0 0 0 0 0 0 0 0 0 0 0 0 0 0 0 0 0 0 0
7 7 7 6 7 7 7 7 6 7 5 6 7 5 7 7 7 7 7 7 7 7 7 7 7 7 7 7 7 7 7 6 7 7 7 7 7 7 7 7
